a#####..........................
......#.........................
......#.........................
......#.........................
......#.........................
###.##...................###..##
........................##......
.......................##.......
.......................#........
.......................#........
................................
.......................#........
....######.............#........
...#......#.....................
...#......#............#........
...#......#.....................
...#......#............#........
####......#.............###..#.#
..........#.....................
...........#........###.........
...........#.......#...#........
...........#.......#...#........
............########...#........
................................
.......................#........
................................
.......................#........
.........########.######........
................................
................................
................................
................................