a##.##........#.................
......#.........................
......#.........................
......#.......#.................
......#........#................
##.#.#....................#..###
.........................#......
........................#.......
................................
.......................#........
................................
.......................#........
....##..##......................
...#......#............#........
...#......#............#........
...#...................#........
...#...................#........
#..#......#..............##..###
#..#............................
###........#........###.........
...........#.......#...#........
...........#..###..#...#........
............##...###...#........
.......................#........
.......................#........
.......................#........
.......................#........
..###..#...#......##..#.........
.#..............................
................................
.###.......###..................
..............#.................